R 500 500
NO maps/textures/VanGogh/vertopal.com_Meadow.xpm
SO maps/textures/VanGogh/vertopal.com_California-Big-Sur-Van-Gogh-Style-Painting-68694955-1.xpm
WE maps/textures/VanGogh/vertopal.com_van-gogh-chateau-at-auvers-at-sunset-1890.xpm
S maps/textures/wolfenstein/Texlibmetallic_3.xpm
EA maps/textures/VanGogh/vertopal.com_Van-Gogh-Cornfield-with-Cypresses-1889-St-Remy-de-Provence-1024-x-695.xpm

C 135,206,235
F 143,182,109

111111111111111111111111111111111111111111111111111111111111111111111111111111
100000000000000000000000000000000000000000000000000000000000000000000000000001
101111111111111111111111111111111111111111111111111000000000000000000000000001
10100N000000000000000000000000000000000000000000001000000000000000000000000001
101011111111111111111111111111111111111111111111101000111111111111111111111101
101000000000000000000000000000000000000000000000001000100000000000000000000001
101000000000000000000000000000000000000000000000001000100000000000000000000001
101011111111111111111111111111111111111111111111111000111111111111111111111101
101000000000000000000000000000000000000000000000000000000000000000000000000001
101000011111111111111111111111111111111111111111111111111111111111111111111101
101000010000000000000000000000000000000000000000000000000000000000000000000001
101000010000000000000000000000000000000000000000000000000000000000000000000001
101000010000000011111111111111111111111111111111111111111111111111111111111101
101000010000000010000000000000000000000000000000000000000000000000000000000001
101000010000000010000000000000000000000000000000000000000000000000000000000001
101000010000000010000000000000000000000000000000000000000000000000000000000001
101000010000000011111111111111111111111111111111111111111111111111111111111101
101000010000000000000000000000000000000000000000000000000000000000000000000001
101000011111111111111111111111111111111111111111111111111111111111111111111101
101000000000000000000000000000000000000000000000000000000000000000000000000001
101111111111111111111111111111111111111111111111111111111111111111111111111101
100000000000000000000000000000000000000000000000000000000000000000000000000001
111111111111111111111111111111111111111111111111111111111111111111111111111111
